1 1:3 2:4 3:3.5 5:1 9:40 12:1 15:6 18:1 19:11 21:1 24:1 29:1 33:1 36:1
1 1:2 2:4.5 3:4 5:1 9:37 12:1 18:1 19:11 21:1 26:1 29:1 31:1 37:1
1 1:1 2:5.7 5:1 9:40 12:1 15:4 18:1 19:11 22:1 24:1 29:1 33:1 37:1
1 1:1 2:2.8 8:1 9:35 13:1 15:2 18:1 19:12 20:1 26:1 30:1 33:1 37:1
1 1:1 2:6 8:1 9:38 13:1 14:8 15:3 18:1 19:9 22:1 26:1 30:1 33:1 37:1
0 1:2 2:4 3:5 5:1 9:40 10:1 15:3 17:1 19:10 20:1 25:1 27:1 33:1 34:1
1 1:3 2:5 3:4.4 5:1 9:38 12:1 14:10 15:6 18:1 19:11 22:1 24:1 30:1 33:1 36:1
1 1:3 2:3.5 3:4 4:4.5 6:1 9:35 13:1 18:1 19:13 22:1 26:1 30:1 31:1 36:1
0 1:3 2:2 3:2 4:2 5:1 9:40 10:1 18:1 19:10 20:1 26:1 28:1 31:1 36:1
1 1:2 2:6.4 3:6.4 8:1 9:38 13:1 15:4 18:1 19:15 23:1 26:1 29:1 33:1 37:1
0 1:2 2:2.5 3:2.5 8:1 9:38 12:1 18:1 19:10 21:1 26:1 30:1 33:1 37:1
1 1:2 2:7 3:5.3 8:1 13:1 18:1 19:11 23:1 24:1 29:1 33:1 37:1
1 1:2 2:5.7 3:4.5 5:1 9:40 11:1 18:1 19:11 21:1 24:1 29:1 31:1 36:1
0 1:3 2:2 3:2.5 8:1 9:35 10:1 18:1 19:10 21:1 26:1 30:1 31:1 36:1
0 1:2 2:2 3:3 5:1 9:38 12:1 16:1 19:12 22:1 24:1 27:1 31:1 36:1
1 1:2 2:4.5 3:5.8 8:1 9:35 11:1 16:1 19:11 20:1 26:1 29:1 33:1 36:1
0 1:2 2:2.5 3:3 8:1 9:40 10:1 18:1 19:11 20:1 26:1 30:1 33:1 37:1
1 8:1 9:38 12:1 15:5 18:1 19:11 22:1 24:1 28:1 31:1 35:1
0 1:2 2:4 3:4 5:1 9:40 10:1 15:3 18:1 19:10 20:1 25:1 27:1 33:1 34:1
1 1:2 2:4.5 3:4 5:1 9:40 13:1 15:4 18:1 19:12 21:1 24:1 29:1 31:1 35:1
0 1:2 2:2 3:2 5:1 9:40 10:1 17:1 19:11 21:1 24:1 27:1 31:1 36:1
1 1:2 2:4.5 3:4 8:1 9:40 13:1 15:4 18:1 19:10 22:1 26:1 28:1 33:1 36:1
1 1:2 2:4.5 3:4 5:1 9:40 13:1 15:5 18:1 19:11 21:1 26:1 29:1 31:1 36:1
1 1:3 2:3.5 3:4 4:4.6 5:1 9:36 13:1 15:3 18:1 19:13 22:1 26:1 30:1 31:1 36:1
1 1:3 2:3.5 3:4 4:4.6 6:1 9:27 13:1 18:1 23:1 26:1 30:1 33:1 37:1
0 1:1 2:2 5:1 9:38 10:1 16:1 19:11 21:1 25:1 27:1 32:1 34:1
1 1:3 2:6 3:6 4:4 8:1 9:35 13:1 15:14 18:1 19:9 22:1 24:1 29:1 31:1 36:1
1 1:2 2:4.3 3:4.4 8:1 9:38 13:1 15:4 18:1 19:12 22:1 26:1 29:1 33:1 36:1
1 1:3 2:6.9 3:4.8 4:2.3 8:1 9:40 13:1 15:3 18:1 19:12 20:1 26:1 30:1 33:1 37:1
0 1:2 2:2.5 3:2.5 7:1 9:39 12:1 18:1 19:12 21:1 26:1 30:1 31:1 37:1
1 1:1 2:3 5:1 9:36 13:1 15:10 17:1 19:11 22:1 26:1 30:1 33:1 37:1
1 1:2 2:5 3:4 5:1 9:37 13:1 15:5 17:1 19:11 20:1 24:1 29:1 31:1 36:1
1 1:3 2:2 3:3 6:1 12:1 16:1 23:1 24:1 28:1 31:1 37:1
0 1:3 2:2 3:2.5 4:2 8:1 9:37 12:1 18:1 19:10 21:1 26:1 30:1 31:1 34:1
