1 1:38 2:1 3:2 4:2 5:2 6:2 7:2 8:2 9:2 10:2 11:2 12:2 13:2 14:0.7 15:53 16:42 17:4.1 18:85 19:2
1 1:50 2:2 3:1 4:2 5:1 6:2 7:2 8:1 9:1 10:1 11:1 12:2 13:2 14:0.9 15:230 16:117 17:3.4 18:41 19:2
1 1:30 2:1 3:1 4:2 5:1 6:1 7:2 8:2 9:1 10:2 11:1 12:2 13:2 14:0.8 15:147 16:128 17:3.9 18:100 19:2
1 1:41 2:2 3:2 4:1 5:1 6:1 7:1 8:2 9:2 10:2 11:2 12:2 13:2 14:0.7 15:81 16:53 17:5 18:74 19:1
0 1:50 2:1 3:2 4:2 5:1 6:2 7:2 8:2 9:1 10:1 11:2 12:1 13:1 14:2.8 15:155 16:75 17:2.4 18:32 19:2
1 1:52 2:1 3:1 4:1 5:2 6:2 7:2 8:2 9:2 10:2 11:2 12:2 13:2 14:0.7 15:75 16:55 17:4 18:21 19:1
1 1:34 2:1 3:1 4:2 5:1 6:2 7:2 8:1 9:1 10:2 11:1 12:2 13:2 14:1 15:72 16:46 17:4.4 18:57 19:1
1 1:25 2:2 3:1 4:1 5:2 6:2 7:2 8:2 9:2 10:2 11:2 12:2 13:2 14:0.4 15:45 16:18 17:4.3 18:70 19:1
0 1:49 2:1 3:1 4:2 5:1 6:1 7:2 8:2 9:2 10:1 11:1 12:2 13:2 14:1.4 15:85 16:70 17:3.5 18:35 19:2
1 1:41 2:1 3:2 4:1 5:1 6:2 7:2 8:2 9:1 10:2 11:2 12:2 13:2 14:0.9 15:81 16:60 17:3.9 18:52 19:1
1 1:51 2:1 3:1 4:1 5:1 6:1 7:2 8:2 9:2 10:2 11:2 12:2 13:2 14:1 15:78 16:58 17:4.6 18:52 19:1
1 1:32 2:1 3:2 4:2 5:1 6:1 7:1 8:2 9:2 10:2 11:1 12:2 13:1 14:3.5 15:215 16:54 17:3.4 18:29 19:1
1 1:38 2:1 3:1 4:1 5:2 6:2 7:2 8:1 9:1 10:2 11:2 12:2 13:2 14:0.7 15:70 16:28 17:4.2 18:62 19:1
1 1:34 2:2 3:2 4:2 5:1 6:1 7:1 8:1 9:1 10:2 11:1 12:2 13:2 14:0.7 15:70 16:24 17:4.1 18:100 19:2
1 1:40 2:1 3:1 4:2 5:1 6:2 7:2 8:2 9:1 10:2 11:2 12:2 13:2 14:0.6 15:62 16:166 17:4 18:63 19:1
1 1:37 2:1 3:2 4:2 5:2 6:2 7:2 8:2 9:2 10:2 11:2 12:2 13:2 14:0.7 15:26 16:58 17:4.5 18:100 19:1
1 1:25 2:1 3:2 4:2 5:1 6:2 7:2 8:1 9:1 10:1 11:1 12:1 13:1 14:1.3 15:181 16:181 17:4.5 18:57 19:2
0 1:47 2:1 3:2 4:2 5:1 6:1 7:2 8:2 9:1 10:2 11:2 12:1 13:1 14:1.7 15:86 16:20 17:2.1 18:46 19:2
1 1:30 2:1 3:1 4:2 5:2 6:2 7:2 8:2 9:2 10:2 11:2 12:2 13:2 14:0.7 15:100 16:31 17:4 18:100 19:1
1 1:53 2:2 3:1 4:2 5:1 6:2 7:2 8:2 9:2 10:1 11:1 12:2 13:1 14:1.5 15:81 16:19 17:4.1 18:48 19:2
1 1:58 2:2 3:2 4:2 5:1 6:2 7:2 8:2 9:1 10:2 11:1 12:2 13:2 14:1.4 15:175 16:55 17:2.7 18:36 19:1
1 1:56 2:1 3:1 4:2 5:1 6:2 7:2 8:2 9:2 10:2 11:2 12:2 13:2 14:0.7 15:71 16:18 17:4.4 18:100 19:1
1 1:39 2:1 3:2 4:2 5:1 6:2 7:2 8:2 9:2 10:2 11:2 12:2 13:2 14:1 15:34 16:15 17:4 18:54 19:1
1 1:33 2:1 3:2 4:2 5:2 6:2 7:2 8:2 9:2 10:2 11:2 12:2 13:2 14:1 15:46 16:90 17:4.4 18:60 19:1
1 1:28 2:1 3:1 4:2 5:1 6:1 7:1 8:2 9:1 10:2 11:2 12:2 13:2 14:1.6 15:44 16:123 17:4 18:46 19:1
1 1:65 2:1 3:2 4:2 5:1 6:1 7:2 8:2 9:1 10:1 11:1 12:1 13:2 14:0.3 15:180 16:53 17:2.9 18:74 19:2
1 1:34 2:2 3:1 4:1 5:2 6:2 7:2 8:2 9:1 10:2 11:2 12:2 13:2 14:0.6 15:30 16:24 17:4 18:76 19:1
1 1:31 2:1 3:1 4:2 5:1 6:2 7:2 8:2 9:2 10:2 11:2 12:2 13:2 14:1.2 15:75 16:173 17:4.2 18:54 19:2
1 1:51 2:1 3:1 4:2 5:1 6:1 7:1 8:2 9:1 10:1 11:1 12:2 13:1 14:4.6 15:215 16:269 17:3.9 18:51 19:2
1 1:31 2:1 3:2 4:2 5:2 6:2 7:2 8:2 9:2 10:2 11:2 12:2 13:2 14:1 15:85 16:20 17:4 18:100 19:1
1 1:40 2:1 3:2 4:1 5:1 6:2 7:2 8:2 9:1 10:1 11:2 12:2 13:2 14:1.2 15:85 16:31 17:4 18:100 19:1
1 1:45 2:1 3:2 4:1 5:2 6:2 7:2 8:2 9:2 10:2 11:2 12:2 13:2 14:1.3 15:85 16:44 17:4.2 18:85 19:2
1 1:54 2:1 3:1 4:1 5:2 6:2 7:2 8:1 9:1 10:2 11:2 12:2 13:2 14:1 15:155 16:225 17:3.6 18:67 19:2
1 1:20 2:1 3:1 4:2 5:1 6:1 7:1 8:2 9:2 10:2 11:1 12:1 13:2 14:1 15:160 16:118 17:2.9 18:23 19:2
1 1:54 2:1 3:2 4:2 5:2 6:2 7:2 8:2 9:2 10:2 11:2 12:2 13:2 14:1 15:85 16:30 17:4.5 19:2
1 1:32 2:1 3:2 4:2 5:2 6:2 7:2 8:2 9:2 10:2 11:2 12:2 13:2 14:0.7 15:102 16:64 17:4 18:90 19:1
1 1:36 2:1 3:1 4:2 5:2 6:2 7:2 8:2 9:2 10:1 11:2 12:2 13:2 14:0.8 15:85 16:44 17:4.2 18:85 19:1
1 1:39 2:1 3:1 4:1 5:2 6:2 7:2 8:1 9:1 10:2 11:2 12:2 13:2 14:1.3 15:78 16:30 17:4.4 18:85 19:1
1 1:40 2:1 3:1 4:1 5:1 6:1 7:1 8:1 9:1 10:2 11:2 12:2 13:2 14:0.6 15:40 16:69 17:4.2 18:67 19:2
1 1:35 2:1 3:2 4:2 5:1 6:2 7:2 8:2 9:2 10:2 11:2 12:2 13:2 14:0.9 15:58 16:92 17:4.3 18:73 19:1
1 1:32 2:1 3:2 4:1 5:1 6:2 7:2 8:2 9:1 10:2 11:1 12:2 13:2 14:1 15:59 16:249 17:3.7 18:54 19:1
1 1:42 2:1 3:1 4:2 5:2 6:2 7:2 8:2 9:2 10:2 11:2 12:2 13:2 14:1 15:85 16:14 17:4 18:100 19:1
0 1:47 2:1 3:2 4:2 5:1 6:1 7:2 8:2 9:1 10:2 11:1 12:1 13:1 14:1 15:166 16:30 17:2.6 18:31 19:2
1 1:26 2:2 3:1 4:2 5:2 6:2 7:2 8:2 9:1 10:2 11:2 12:2 13:2 14:0.5 15:135 16:29 17:3.8 18:60 19:1
0 1:33 2:1 3:1 4:2 5:1 6:1 7:2 8:2 9:2 10:2 11:2 12:1 13:2 14:0.7 15:63 16:80 17:3 18:31 19:2
0 1:38 2:1 3:1 4:2 5:2 6:2 7:2 8:2 9:1 10:2 11:2 12:2 13:2 14:0.4 15:243 16:49 17:3.8 18:90 19:2
1 1:27 2:1 3:1 4:2 5:1 6:1 7:2 8:2 9:2 10:2 11:2 12:2 13:2 14:0.8 15:95 16:46 17:3.8 18:100 19:1
0 1:59 2:1 3:1 4:2 5:1 6:1 7:2 8:2 9:1 10:1 11:1 12:2 13:2 14:1.5 15:107 16:157 17:3.6 18:38 19:2
