1 1:38 2:1 3:2 4:1 5:1 6:1 7:1 8:2 9:2 10:2 11:1 12:2 13:2 14:0.7 15:125 16:65 17:4.2 18:77 19:1
1 1:34 2:1 3:2 4:2 5:2 6:2 7:2 8:2 9:2 10:2 11:2 12:2 13:2 14:0.9 15:95 16:28 17:4 18:75 19:1
1 1:23 2:1 3:2 4:2 5:1 6:1 7:1 8:2 9:2 10:1 11:2 12:2 13:2 14:1.3 15:194 16:150 17:4.1 18:90 19:1
1 1:44 2:1 3:2 4:2 5:2 6:2 7:2 8:2 9:2 10:2 11:2 12:2 13:2 14:0.6 15:110 16:145 17:4.4 18:70 19:1
0 1:39 2:1 3:1 4:1 5:1 6:1 7:2 8:2 9:1 10:2 11:2 12:2 13:2 14:2.3 15:280 16:98 17:3.8 18:40 19:1
1 1:28 2:2 3:2 4:2 5:1 6:1 7:2 8:2 9:1 10:2 11:2 12:2 13:2 14:1.8 15:191 16:420 17:3.3 18:46 19:1
1 1:27 2:1 3:2 4:2 5:1 6:1 7:1 8:1 9:1 10:1 11:1 12:2 13:2 14:1.2 15:133 16:98 17:4.1 18:39 19:1
1 1:72 2:1 3:2 4:1 5:1 6:2 7:2 8:2 9:1 10:2 11:2 12:2 13:2 14:1 15:115 16:52 17:3.4 18:50 19:2
1 1:30 2:1 3:2 4:2 5:1 6:2 7:2 8:2 9:1 10:2 11:2 12:2 13:2 14:2.2 15:57 16:144 17:4.9 18:78 19:1
1 1:42 2:1 3:2 4:2 5:2 6:2 7:2 8:2 9:2 10:2 11:2 12:2 13:2 14:0.9 15:60 16:63 17:4.7 18:47 19:1
1 1:38 2:1 3:1 4:2 5:1 6:1 7:1 8:1 9:1 10:2 11:2 12:2 13:2 14:0.6 15:76 16:18 17:4.4 18:84 19:2
1 1:30 2:1 3:2 4:2 5:1 6:2 7:2 8:2 9:2 10:2 11:2 12:2 13:2 14:0.7 15:50 16:78 17:4.2 18:74 19:1
1 1:54 2:1 3:1 4:2 5:1 6:1 7:2 8:2 9:2 10:2 11:2 12:1 13:2 14:1.2 15:85 16:92 17:3.1 18:66 19:2
1 1:64 2:1 3:2 4:1 5:1 6:1 7:2 8:1 9:1 10:2 11:2 12:2 13:2 14:1 15:80 16:38 17:4.3 18:74 19:1
0 1:57 2:1 3:1 4:2 5:1 6:1 7:2 8:2 9:2 10:2 11:1 12:1 13:2 14:4.6 15:82 16:55 17:3.3 18:30 19:2
1 1:36 2:1 3:2 4:2 5:2 6:2 7:2 8:2 9:2 10:2 11:2 12:2 13:2 14:0.7 15:62 16:224 17:4.2 18:100 19:1
1 1:38 2:1 3:2 4:2 5:2 6:2 7:2 8:2 9:1 10:2 11:1 12:2 13:1 14:1.6 15:130 16:140 17:3.5 18:56 19:2
0 1:42 2:1 3:1 4:1 5:1 6:1 7:2 8:2 9:2 10:2 11:1 12:2 13:2 14:0.5 15:62 16:68 17:3.8 18:29 19:2
0 1:48 2:1 3:1 4:2 5:1 6:1 7:2 8:2 9:1 10:2 11:1 12:1 13:1 14:4.8 15:123 16:157 17:2.7 18:31 19:2
1 1:49 2:1 3:2 4:2 5:1 6:1 7:2 8:2 9:2 10:2 11:2 12:2 13:2 14:0.8 15:103 16:43 17:3.5 18:66 19:1
1 1:22 2:2 3:2 4:1 5:1 6:2 7:2 8:2 9:2 10:2 11:2 12:2 13:2 14:0.9 15:48 16:20 17:4.2 18:64 19:1
1 1:50 2:1 3:2 4:2 5:2 6:2 7:2 8:2 9:1 10:1 11:1 12:2 13:2 14:1 15:85 16:75 17:4 18:72 19:2
1 1:38 2:1 3:1 4:2 5:1 6:1 7:1 8:2 9:2 10:2 11:2 12:1 13:2 14:2 15:72 16:89 17:2.9 18:46 19:1
1 1:62 2:2 3:2 4:2 5:1 6:1 7:2 8:2 9:1 10:2 11:1 12:2 13:2 14:1.3 15:141 16:156 17:3.9 18:58 19:1
1 1:30 2:1 3:2 4:1 5:2 6:2 7:2 8:2 9:2 10:2 11:2 12:2 13:2 14:0.7 15:52 16:38 17:3.9 18:52 19:1
1 1:50 2:1 3:2 4:2 5:2 6:2 7:2 8:2 9:2 10:2 11:2 12:2 13:2 14:1 15:139 16:81 17:3.9 18:62 19:2
1 1:32 2:1 3:1 4:1 5:1 6:1 7:2 8:2 9:2 10:2 11:2 12:2 13:2 14:1 15:55 16:45 17:4.1 18:56 19:1
0 1:47 2:1 3:2 4:2 5:2 6:2 7:2 8:2 9:2 10:2 11:1 12:2 13:1 14:2 15:84 16:23 17:4.2 18:66 19:2
1 1:61 2:1 3:1 4:2 5:1 6:2 7:2 8:1 9:1 10:2 11:2 12:2 13:2 14:1.3 15:78 16:25 17:3.8 18:100 19:1
1 1:36 2:1 3:1 4:2 5:2 6:2 7:2 8:1 9:1 10:1 11:2 12:2 13:2 14:0.7 15:164 16:44 17:3.1 18:41 19:1
1 1:27 2:1 3:1 4:2 5:1 6:2 7:2 8:2 9:1 10:2 11:2 12:2 13:2 14:2.4 15:168 16:227 17:3 18:66 19:2
0 1:43 2:1 3:2 4:2 5:1 6:2 7:2 8:2 9:2 10:1 11:1 12:1 13:2 14:1.2 15:100 16:19 17:3.1 18:42 19:2
